24 30
0 0 0 0 0 0 0 0 0 0 0 0 0 0 0 0 0 0 18 18 18 18 18 0
0 0 11 0 11 12 11 13 11 0 0 0 0 0 0 0 0 0 16 20 16 20 16 0
0 0 2 12 2 0 2 0 2 0 0 0 0 0 0 0 0 9 16 16 14 16 16 9
0 1 0 0 0 0 0 13 0 12 0 0 0 0 0 0 0 10 16 16 22 16 16 10
0 0 0 0 0 13 0 0 0 0 0 0 0 0 0 0 0 0 0 0 2 0 0 0
0 0 0 0 0 7 6 0 0 0 0 0 0 0 0 0 0 0 0 2 2 2 0 0
0 0 0 0 5 4 0 0 0 0 0 0 0 1 0 0 0 0 0 0 0 0 0 0
0 0 0 0 0 7 0 0 0 0 0 0 0 0 0 0 0 0 0 0 0 0 0 13
0 0 0 0 0 7 0 0 0 0 0 0 0 0 0 0 0 0 0 0 0 0 0 0
0 0 0 0 0 0 0 13 0 0 0 0 0 0 0 0 0 5 7 0 0 0 0 0
0 0 0 0 0 0 0 0 0 0 0 0 0 0 0 13 0 0 7 0 0 0 0 0
0 0 0 0 0 0 0 0 0 0 18 11 19 0 0 0 0 0 7 6 0 0 0 0
0 0 0 0 0 0 0 0 9 0 20 16 20 0 9 0 0 0 0 0 0 0 0 0
0 0 1 0 0 0 0 0 10 0 16 22 16 0 10 0 0 0 0 0 0 0 0 0
0 0 0 0 0 0 0 0 0 0 0 2 0 0 0 0 0 0 1 0 0 0 0 0
0 0 0 0 0 0 0 0 0 0 0 2 0 0 0 0 0 0 0 0 0 0 0 0
0 0 0 0 0 0 0 0 13 0 0 0 0 0 0 0 0 0 0 0 0 0 0 0
0 0 0 0 0 0 0 0 1 0 0 0 0 0 0 0 0 13 0 0 0 0 0 0
0 0 0 0 0 0 0 0 0 0 0 0 0 0 0 0 0 0 0 0 0 0 0 0
0 0 0 0 0 0 0 0 0 0 0 0 0 0 0 0 0 0 0 0 0 0 0 0
0 0 0 0 0 0 0 0 0 0 0 0 0 0 0 0 0 0 0 0 0 0 0 0
0 16 16 16 2 16 16 16 0 0 0 0 0 0 0 0 0 0 0 0 0 0 0 0
0 16 0 9 2 9 8 16 0 0 0 0 0 0 0 0 0 0 0 0 0 0 0 0
0 16 8 10 2 10 0 16 0 0 0 0 0 0 0 0 0 0 0 0 0 0 0 0
0 2 2 2 2 2 2 2 0 0 0 0 0 0 0 0 0 9 0 9 0 9 0 9
0 16 0 9 2 9 0 16 0 0 0 0 0 0 0 0 0 10 11 10 11 10 11 10
0 16 8 10 2 10 0 16 0 0 0 0 0 0 0 0 0 16 14 16 14 16 14 16
0 16 16 16 2 16 16 16 0 0 0 0 0 0 0 0 0 2 2 2 2 2 2 2
0 0 0 0 0 0 0 0 0 0 0 0 0 0 0 0 0 0 0 0 0 0 0 0
0 0 0 0 0 0 0 0 0 0 0 0 0 0 0 0 0 0 0 0 0 0 0 0